0,0, 1,0,_,D
1,0, 1,2,_,D
1,1, _,3,D,_
2,3, 2,2,R,_
0,2, 3,2,R,_
1,2, 2,3,L,R
3,0, 0,1,L,R
3,1, 2,1,L,R
2,0, 0,1,_,L
0,1, _,_,_,L
2,1, 0,1,_,_
0,3, _,3,D,_
3,3, _,_,_,_
