0,0, 2,0,_,D
2,0, 2,2,R,_
0,2, 1,_,R,_
1,2, _,3,_,R
1,0, _,1,_,R
1,1, 3,2,U,L
0,1, 4,2,U,L
0,3, 4,3,_,R
4,2, _,3,_,R
4,0, _,1,D,R
3,0, _,_,L,L
2,1, _,_,_,L
2,3, 0,0,_,_
3,2, 3,1,_,_
3,1, _,_,_,_
