0,0, 1,0,_,D
1,0, 1,2,_,D
1,1, _,_,D,_
2,1, 3,2,R,_
0,2, 2,_,R,_
1,2, 6,_,L,R
2,0, 5,3,L,R
3,0, 4,4,_,_
4,4, 4,_,_,D
4,6, _,_,_,D
4,0, 6,5,_,_
6,5, 7,_,R,L
5,0, _,1,R,L
6,0, _,3,L,R
5,1, _,0,L,R
7,7, 5,5,_,_
7,4, _,0,_,L
7,3, _,0,_,L
7,2, _,1,D,_
7,5, _,6,_,U
5,6, 6,_,R,L
6,3, _,_,L,R
6,6, 5,_,L,R
7,6, _,_,_,U
3,1, _,_,D,_
0,1, _,4,U,_
3,4, _,_,R,_
0,4, _,_,R,_
6,4, _,7,U,_
6,7, _,_,U,_
0,7, 1,7,_,_
1,7, _,_,_,_
