0,0, 1,1,_,D
1,0, 2,2,_,D
2,0, 3,2,_,D
3,0, _,_,_,U
3,2, _,_,_,U
3,3, 0,0,R,R
0,1, 2,2,_,_
1,1, 2,2,_,_
2,1, 2,2,_,_
3,1, 2,2,_,_
2,2, _,_,_,_
