1,0, 5,1,U,_
1,1, 2,_,R,_
5,2, _,1,L,U
0,2, 2,5,_,R
2,0, 5,2,R,_
2,2, 3,_,D,_
5,3, _,2,U,R
0,3, 3,5,_,D
3,0, 5,3,D,_
3,3, 4,_,L,_
5,4, _,3,R,D
0,4, 4,5,_,L
4,0, 5,4,L,_
4,4, 5,_,U,_
5,5, _,4,D,L
0,5, 0,5,_,U
0,0, 1,0,_,U
0,1, 4,2,_,_
2,1, 4,2,_,_
3,1, 4,2,_,_
4,1, 4,2,_,_
5,1, 4,2,_,_
1,2, 2,4,_,_
1,3, 2,4,_,_
1,4, 2,4,_,_
1,5, 2,4,_,_
2,4, _,_,_,_
4,2, _,_,_,_
