0,0, 1,0,_,D
1,0, 0,1,R,_
0,1, 3,_,R,_
1,1, 2,_,_,R
2,0, _,_,_,R
2,1, 3,0,_,_
3,0, 3,_,L,R
3,1, _,_,_,_
