0,0, 3,0,_,D
3,0, 3,2,D,_
0,2, 3,2,D,_
2,2, 3,_,U,_
3,3, _,_,U,_
0,3, _,_,R,R
1,1, 2,_,_,D
0,1, 1,2,_,_
1,0, 2,0,_,_
1,2, 2,_,U,_
2,0, _,_,_,_
3,2, _,_,_,_
